332333233332222222-
232323232232222222-
232323232232222222-
232323232232222222-
232323232232222222-
232323232232222222-
233323332233222222-
222222222222222222